  0 1 2 3 4 5 6 7 8 9 0 1 2 3 4 5 6 7 8 9
0                           1 1          
1 1 1                       1 1          
2 1 1                       1 1          
3 1 1     1 1 1 1     1 1 1 1 1          
4 1 1 1   1 1 1 1     1 1 1 1 1          
5 1 1 1   1 1 1 1           1 1          
6         1 1 1 1           1 1          
7         1                 1 1          
8     1 1 1                 1 1          
9     1 1 1               1 1 1          
0         1       1 1 1 1 1 1 1          
1         1   1 1 1 1 1 1 1 1 1          
2         1   1 1 1 1 1                  
3         1                              
4         1                       1      
5         1       1             1 1      
6               1 1           1 1        
7             1 1 1         1 1          
8           1 1 1 1       1 1            
9           1 1 1 1     1 1              
